8
F F K F F F F F
F P P P P P O F
F P P P P P F F
F F P P F P P F
F P P P F P P F
F P P P P P P F
F P J P P P P F
F F F F F F F F